Breakfast in the Dolomites
A play just for fun comedy by Roberto Ceccarelli
Release 1 / Serial number 240601 / Inform 7 v10.1.2 / D

Reception
This charming little hotel welcomes guests with its cosy reception area: the inviting atmosphere is immediately apparent, with a blend of rustic elegance and modern comfort. 
The receptionist stands behind a tastefully crafted wooden desk, ready to assist guests with a genuine smile. 
Stairs lead to the upper floors. To the east is the dining room, along the wall is a door. 

The reception of this little hotel in the Dolomites serves as the perfect introduction to the unique blend of comfort and authenticity that awaits guests throughout their stay, promising a memorable and rejuvenating experience in this picturesque mountain retreat. 

Reception
The receptionist stands behind a tastefully crafted wooden desk, ready to assist guests with a genuine smile. 
Stairs lead to the upper floors. To the east is the dining room, along the wall is a door. 

Monica is next to you.

Please press SPACE to continue.

Breakfast in the Dolomites
A play just for fun comedy by Roberto Ceccarelli
Release 1 / Serial number 240421 / Inform 7 v10.1.2 / D

Reception
This charming little hotel welcomes guests with its cosy reception area: the inviting atmosphere is immediately apparent, with a blend of rustic elegance and modern comfort. 
The receptionist stands behind a tastefully crafted wooden desk, ready to assist guests with a genuine smile. 
Stairs lead to the upper floors. To the east is the dining room, along the wall is a door. 

The reception of this little hotel in the Dolomites serves as the perfect introduction to the unique blend of comfort and authenticity that awaits guests throughout their stay, promising a memorable and rejuvenating experience in this picturesque mountain retreat. 

Reception
The receptionist stands behind a tastefully crafted wooden desk, ready to assist guests with a genuine smile. 
Stairs lead to the upper floors. To the east is the dining room, along the wall is a door. 

Monica is next to you.

* * *

>z
Time passes.

It's time to check in: you have just arrived at the hotel.

>up
You and Monica bid farewell to the receptionist and set off up the stairs. 
"Have a good night!" — the receptionist wishes you. 
♥ Monica wraps her arm around your waist and gives you a kiss on the neck.

Please press SPACE to continue.

The morning after. 

After a good night's sleep, you are ready to enjoy the first day of your holiday. 
You and Monica go down the stairs and back to reception. 
You wear a pair of brown trekking boots, a checkered flannel shirt, a white t-shirt and a pair of beige shorts; Monica wears a pair of pink trekking shoes, a pair of black leggings and a black sweatshirt. 
The receptionist are working behind the counter. 

"Miss Monica and Mr. Francesco good morning!" — the receptionist wishes, "You're looking good today!" 

"Good morning." — Monica says to the receptionist.

>hi
"Good morning." — you say to the receptionist.

>ask about table
"Please feel free to ask my colleagues in the dining room about it." — he replies.

>e
Monica follows you.

Dining room
Rustic wooden beams and locally sourced stone accents complement the alpine setting, while tasteful decor elements pay homage to the region's cultural heritage. The tables are elegantly set with crisp linens. Around the tables is a bench covered in dark green velvet. 
Bathed in natural light that filters through large windows, the room offers panoramic views of the surrounding majestic peaks, creating a serene and inspiring atmosphere. 
The reception area is to the west, to the north is the buffet area, and to the east a door leads to the kitchen.

Monica is next to you.

You can see a waiter and a waitress here.

♥ "Very nice, isn't it?" — Monica asks, — "I wonder at which table we can sit."

>ask about table
You need to specify who you want to speak to.

>ask waiter about table
You approach the waiter and say hello: — "Good morning, we are staying in the "Edelweiss" room and it is our first day here." 
"Oh, welcome! Let me show you to your table." — the waiter says and goes to a free table. 
"This is the table we have reserved for you, I hope it is to your liking." — he points to you the table.
♥ "It's perfect!" — Monica exclaims — "Thank you."

* * *

>hi
"Good morning." — you say to the receptionist.

>e
Monica follows you.

Dining room
Rustic wooden beams and locally sourced stone accents complement the alpine setting, while tasteful decor elements pay homage to the region's cultural heritage. The tables are elegantly set with crisp linens. Around the tables is a bench covered in dark green velvet. 
Bathed in natural light that filters through large windows, the room offers panoramic views of the surrounding majestic peaks, creating a serene and inspiring atmosphere. 
The reception area is to the west, to the north is the buffet area, and to the east a door leads to the kitchen.

Monica is next to you.

You can see a waiter and a waitress here.

♥ "Very nice, isn't it?" — Monica asks, — "I wonder at which table we can sit."

>hi
You approach the waiter and say hello: You approach the waiter and say hello: — "Good morning, we are staying in the "Edelweiss" room and it is our first day here." 
"Oh, welcome! Let me show you to your table." — the waiter says and goes to a free table. 
"This is the table we have reserved for you, I hope it is to your liking." — he points to you the table.
♥ "It's perfect!" — Monica exclaims — "Thank you."

>put key on table
You put the room key on the table.

Monica sits down on the bench.

>sit
You get onto the bench.

Monica is next to you.

"May I serve you a hot beverage?" — the waiter asks, then explains: — "I can offer you a coffee, a cappuccino, a hot chocolate or a tea."

>cappuccino
"Regular, soy milk or barley coffee?" — he asks you to choose.

>regular
"Good choice." — the waiter confirms you. 
"What can I get for you, miss?" — he asks Monica. 
"A cup of hot chocolate." — Monica answers. 
"Perfect!" — the waiter exclaims. 
"I'll be back soon with what you've ordered." — he says — "In the meantime, you can help yourself to the buffet." 

The waiter goes to the kitchen.

>n
(first getting off the bench)
You stand up.

Buffet
The buffet is a feast for the senses, featuring a variety of locally sourced and homemade delights. Guests can savor freshly baked artisanal breads, jams, and a selection of cheeses and cured meats, showcasing the flavors of the Dolomites.

To the right is a wooden cupboard. On it are some empty dishes and containers with cold drinks.
Next to the sideboard is a small table with a juicer on it and two small wooden crates of celery ribs and carrots.
To the left is a table on which are bread, butter, jams, meats and cheese.
Next to the buffet table there is another table, behind which a cook is on hand to cook the eggs that are in a basket.
You can see a HACCP ingredients book here.

Monica stands up and follows you at the buffet.

>take dish
Taken.

>put speck on dish
(first taking the slice of speck)
You put the slice of speck on the dish.

Monica takes a dish from the cupboard.

>take bread
Which do you mean, a slice of white bread or a slice of pumpernickel bread?

>black
Taken.

Monica takes a slice of white bread and puts it on the dish she is carrying.

>put bread on dish
(the slice of pumpernickel bread on the dish)
You put the slice of pumpernickel bread on the dish.

Monica takes a knob of butter and puts it on the dish she is carrying.

>put black bread on dish
(first taking the slice of pumpernickel bread)
You put the slice of pumpernickel bread on the dish.

Monica takes a apricot jam portion jar and puts it on the dish she is carrying.

>put butter on dish
(first taking the knob of butter)
You put the knob of butter on the dish.

>put marmalade on dish
(first taking the orange marmalade portion jar)
You put the orange marmalade portion jar on the dish.

>ask cook for a glass
"The glasses are in a drawer of the cupboard." — she replies.

"May I cook an egg for you?" — the cook asks, then explains: — "I can offer you a fried egg, an omelette or a crêpe."

>fried
"Bull's eye or scrambled?" — she asks you to choose.

>scrambled
"Your scrambled fried egg will be ready in a couple of minutes." — the cook says. 

The cook takes an egg, breaks it by tapping it on the edge of a frying pan and then carefully pours the contents into the pan.
She throws the eggshell into a bin under the table.

>ask cook for a dish
"The eggs I cook are already on a dish," — she says — "if you need an empty plate you will find it on the cupboard." 

The cook uses a fork to mix the egg yolk with the abume, creating a white mixture with yellow flecks.

>open left drawer
You open the left drawer, revealing ten empty glasses.

"Here's your scrambled fried egg!" — the cook says handing you the dish.

>get dish
You take the dish from the cook.

"Can I prepare something for you too, Miss?" — the cook asks to Monica.
"I would like a crêpe." — Monica replies.
"Good choice!" — the cook confirms — "It will be ready in a few minutes."

>take glass
Monica also takes a glass.
She then closes the drawer.

>pour apple in the glass
You pour apple juice into the glass.

Monica pours some orange juice in her glass.

>s
"Don't go away!" — Monica draws your attention: — "I'm waiting for a crêpe." 

"Here's your crêpe, Miss." — the cook says to Monica handing her the dish.
"Thank you." — Monica says getting the dish. 
"Don't mention it!" — the cook replies.

>s
Dining room
The tables are elegantly set with crisp linens. Around the tables is a bench covered in dark green velvet. 
The reception area is to the west, to the north is the buffet area, and to the east a door leads to the kitchen.

You can see a waitress here.

Monica returns with you in the dining room and sits on the bench.
Then she puts the dishes and the glass she has brought from the buffet on the table.

>sit
You get onto the bench.

Monica is next to you.

The waiter returns with a tray containing your order. 
"Here are your hot drinks!" — he exclaims — "A cup of cappuccino and a mug of hot chocolate." 
The waiter then places the contents of the tray on the table. 

(Monica first taking the crêpe)
Monica eats her crêpe. 
It seems to have been really good, judging by her expression.

>drink chocolate
The mug of hot chocolate belongs to Monica.

Monica takes her mug of hot chocolate and drinks the hot chocolate.
Then she puts the mug on the table.
"The hot chocolate was really good," — Monica states and suggests — "why don't you try it?"

>drink cappuccino
(first taking the cup of cappuccino)
You're carrying too many things already.

"Drink your cup of cappuccino before it gets cold." — Monica suggests you.

The waiter leave.

>put glass on table
(the glass of apple juice on the table)
You put the glass of apple juice on the table.

Monica spreads the knob of butter on her slice of white bread.

>put dish on table
You put the dish on the table.

"Drink your cup of cappuccino before it gets cold." — Monica suggests you.

Monica opens the apricot jam portion jar.

>put dish on table
You put the dish on the table.

Monica spreads the portion of apricot jam over the buttered slice of white bread.

>drink cappuccino
(first taking the cup of cappuccino)
You drink the cappuccino, leaving the cup empty. 
Characterised by the unmistakable aromas of coffee, its bitter taste and the roundness of whipped milk that sticks around the mouth.

The waitress collects all the empty dishes, glasses and cups from the table. 
Then she goes to the kitchen.

Monica throws the apricot jam portion jar in the round plastic container.

>put the cup on the table
You put the empty cup on the table.

(Monica first taking the buttered slice of white bread dressed with a portion of apricot jam)
Monica eats the buttered slice of white bread dressed with a portion of apricot jam.

♥ "Delicious!" — Monica exclaims — "You really took me to a nice place."

>put speck on black bread
Now you have a slice of pumpernickel bread dressed with a slice of speck.

Monica takes her glass of orange juice and drinks the juice.
After drinking Monica puts the empty glass on the table again.

>eat bread
(first taking the slice of pumpernickel bread dressed with a slice of speck)
You eat the slice of pumpernickel bread dressed with a slice of speck. Not bad.

The waitress collects all the empty dishes, glasses and cups from the table. 
Then she goes to the kitchen.

>x table
On the table are a dish (on which are an orange marmalade portion jar (closed), a knob of butter and a slice of pumpernickel bread), a dish (on which is a scrambled fried egg), a glass of apple juice, a room key, two knives, two teaspoons, two forks, two towels, a round plastic container (in which is an apricot jam portion jar (empty)) and a written paper.

>open marmalade
You open the orange marmalade portion jar, revealing a portion of orange marmalade.

>spread butter on bread
Now you have a buttered slice of pumpernickel bread.

>spread marmalade on bread
(the portion of orange marmalade on the buttered slice of pumpernickel bread)
Now you have a buttered slice of pumpernickel bread dressed with a portion of orange marmalade.

>eat bread
(first taking the buttered slice of pumpernickel bread dressed with a portion of orange marmalade)
You eat the buttered slice of pumpernickel bread dressed with a portion of orange marmalade. Not bad.

♤ "Next time be tidier!" — Monica says throwing your orange marmalade portion jar in the round plastic container.

>x table
On the table are a dish, a dish (on which is a scrambled fried egg), a glass of apple juice, a room key, two knives, two teaspoons, two forks, two towels, a round plastic container (in which are an orange marmalade portion jar (empty) and an apricot jam portion jar (empty)) and a written paper.

>eat egg
(first taking the scrambled fried egg)
You eat the scrambled fried egg. Not bad.

>drink apple juice
(first taking the glass of apple juice)
You drink the apple juice, leaving the glass empty. 
Clear and crystalline, with an inviting straw-yellow colour, it offers a sweet, natural and fresh flavour.

The waiter collects all the empty dishes, glasses and cups from the table. 
Then he goes to the kitchen.

>put glass on table
You put the empty glass on the table.

♥ "There was a juice extractor at the buffet, I would love to try one of those juices." — Monica says looking at you with sweet love eyes — "Would you be so kind as to bring me one?"

>no
♤ "How unpleasant you are this morning!" — Monica scolds you — "Don't you want to do a kindness to your girlfriend who loves you so much?"

>do it yourself
"It is completely useless to try to change the subject, you know you can give me only one answer." — Monica says pointing a finger at you.

>fuck
"It is completely useless to try to change the subject, you know you can give me only one answer." — Monica says pointing a finger at you.

>yes
♥ "My love!" — Monica replies caressing you — "You can choose the vegetable." 
You stand up and go to the buffet; Monica sends you a kiss. ♥ 

Buffet
The buffet is a feast for the senses, featuring a variety of locally sourced and homemade delights. Guests can savor freshly baked artisanal breads, jams, and a selection of cheeses and cured meats, showcasing the flavors of the Dolomites.

To the right is a wooden cupboard. On it are some empty dishes and containers with cold drinks.
Next to the sideboard is a small table with a juicer on it and two small wooden crates of celery ribs and carrots.
To the left is a table on which are bread, butter, jams, meats and cheese.
Next to the buffet table there is another table, behind which a cook is on hand to cook the eggs that are in a basket.
You can see a HACCP ingredients book here.

>fuck
I'm sorry if you're feeling frustrated. If you like, you can type SAVE to store your progress to a file (in most interpreters), then RESTORE to come back to it later. In the meantime, you might try searching the web to see if there are hints available.

* * *

>put glass on table
You put the empty glass on the table.

♥ "There was a juice extractor at the buffet, I would love to try one of those juices." — Monica says looking at you with sweet love eyes — "Would you be so kind as to bring me one?"

>yes
♥ "My love!" — Monica replies caressing you — "You can choose the vegetable." 
You stand up and go to the buffet; Monica sends you a kiss. ♥ 

Buffet
The buffet is a feast for the senses, featuring a variety of locally sourced and homemade delights. Guests can savor freshly baked artisanal breads, jams, and a selection of cheeses and cured meats, showcasing the flavors of the Dolomites.

To the right is a wooden cupboard. On it are some empty dishes and containers with cold drinks.
Next to the sideboard is a small table with a juicer on it and two small wooden crates of celery ribs and carrots.
To the left is a table on which are bread, butter, jams, meats and cheese.
Next to the buffet table there is another table, behind which a cook is on hand to cook the eggs that are in a basket.
You can see a HACCP ingredients book here.

>s
Monica is waiting for a juice.

>open left drawer
You open the left drawer, revealing nine empty glasses.

>take glass
Taken.

>fill glass with orange
You should fill the empty glass with a vegetable juice.

>ask cook about juicer
"Can you help me to extract some juice?" — you ask.
"Of course!" — she answers — "Choose a vegetable and chop it, then put it in the machine and start." 
"Oh, it seems to be easy!" — you say.

"Do not forget the glass. When you are finished, turn off the machine." — the cook remember.

"May I cook an egg for you?" — the cook asks, then explains: — "I can offer you a fried egg, an omelette or a crêpe."

>no
"If you need anything later, I am here to help you." — the cook says.

>look at juicer
The machine takes the form of a large steel cylinder. 
At the top, a lid gives access to a container in which to place the vegetables from which the juice is extracted. 
At the bottom there is a recess in which a glass can be placed to collect the juice that comes out of a spout. 
On the right is a switch to turn the machine on and off.

The juicer machine is currently switched off.

>look at juicer table
A small marble-topped table.
On it are a juicer machine, a first crate with several carrots, a second crate with several celery ribs, a knife and a sturdy wooden chopping board which is actually empty.

>put carrot on chopping board
You place the carrot on the sturdy wooden chopping board.

>chop carrot with knife
You chop carrot using the knife in small pieces.

>open juicer
You open the juicer bowl.

>put carrot in juicer
(the chopped carrot in the juicer bowl)
(first taking the chopped carrot)
You put the chopped carrot into the juicer bowl.

>close juicer
You close the juicer bowl.

>put glass in juicer
You put the empty glass into the juicer recess.

>turn on juicer
You switch on the juicer and the carrot juice starts coming down into the glass.

>switch off juicer
You switch the juicer machine off.

No more juice comes down.

>look glass
Which do you mean, an empty glass or the glass of carrot juice?

>close drawer
Which do you mean, the left drawer or the right drawer?

>close open drawer
(I only understood the first part of that — trying anyway.)
Next time, I suggest you write the command as: close open
You can't see any such thing.

>close left drawer
You close the left drawer.

>look glass
The glass is roughly half full of carrot juice.

>take glass
You take the glass of carrot juice from the juicer.

>s
Dining room
The tables are elegantly set with crisp linens. Around the tables is a bench covered in dark green velvet. 
The reception area is to the west, to the north is the buffet area, and to the east a door leads to the kitchen.

On the bench is Monica.

You can also see a waiter and a waitress here.

You return at your table and put the glass of carrot juice in front of Monica.
"Here is your carrot juice." — you say to Monica.
Monica smiles and kisses you.

♥ "I love you!" — she whispers sweetly in your ear.

>z
Time passes.

Monica takes her glass of carrot juice and drinks the juice.
After drinking Monica puts the empty glass on the table again.

>z
Time passes.

The waitress collects all the empty dishes, glasses and cups from the table. 
Then she goes to the kitchen.

♥ "We should find out what the weather is going to be like today and decide what to do." — Monica says. — "In any case, my suggestion is a visit to Cortina for a look at the shop windows." 
"It is always the same!" — you reply — "There are so many beautiful things to see, and all you can think of is to stroll along the windows." 
"Ok." — Monica states — "If the weather is good, we will do as you say, otherwise you will have to take me where you know. So ask someone for the weather forecast."

>z
Time passes.

>call a waiter
A waiter approached. 
"Can I help you?" — he asks.

>ask about weather
"Do you know it might rain today?" — you ask. 
"You can find the weather report in the hotel daily newsletter on your table." — he explains.

>ask about newsletter
"Where can I find the newsletter?" — you ask. 
"It's printed on the back side of the menu." — the waiter reply.

>ask about mountain
"Sorry, I can't help you at this time." — he admits.

"So, we still know nothing about the weather?" — Monica asks.

>turn menu
You can't see any such thing.

>turn written paper
You turn the written paper: now you see the back side.

>x written paper
The daily newsletter

There are several boxes whose titles are: "Weather report", "Tip of the day", "A legend of the Dolomites" and "Hike of the day". 

The waiter leaves.

>read weather
Weather report

Today will be mostly sunny, except for some low clouds in the morning, which will dissipate quickly. In the late afternoon/evening, cloud formation and local rain showers are possible. 
Minimum temperatures between 8°C and 10°C, maximum temperatures between 20°C and 28°C.

"This time you got lucky:" — Monica admits — "we'll go to the mountains." 
"Read which hike they suggest." — Monica adds.

>read hike
Hike of the day

Around the Three Peaks of Lavaredo
The Three Peaks of Lavaredo, the symbol of the Dolomites, have always exerted a certain fascination, attracting climbers and hikers from all over the world. This is a true paradise for those who love hiking, mountaineering and vie ferrate. But that's not all... there are also some easy but breathtaking hikes, such as the tour around the Three Peaks of Lavaredo. The starting point for our walk is the Auronzo Hut (2,320 m).
Crossing the Landro Valley we reach Lake Misurina, where we park our car. From here you can take the shuttle bus to the Auronzo Hut. Then we start our walk on the 101 path, which goes along the south side of the Three Peaks of Lavaredo to the Lavaredo Hut (2,344 m). From here take a small path to the left which leads to the Forcella di Lavaredo (2,454 m). There is a wonderful panoramic view, not only of the surrounding valleys, but also of the northern side of the Three Peaks of Lavaredo. Continue slightly downhill at the foot of Mount Paterno until you come to a fork, where you take the road that leads to the A. Locatelli Hut (2,405 m).
Arriving at the refuge, after a walk of about 1.5 hours, we take a break and sit down on the grass to eat a typical snack of speck, salami and tomatoes. Then we start our way back, first to the Malga Lange (2,232 m, n. 105) and then, at the foot of the western face of the Three Peaks of Lavaredo, to the Auronzo Hut, from where we return to the car.

"Sounds like a nice hike." — Monica comments — "From Misurina to Cortina is not a long way: on the way back we could stop."

>kiss mo
♥ "On dear!" — she whispers sweetly in your ear.

It's been a while since you've gone downstairs for breakfast, and now you feel the urge to go to the bathroom. 
You move a bit nervously, and Monica notices your discomfort. 

♥ "Sweetheart, are you all right?" — Monica asks.
"Go to the toilet, which is better." — she suggests — "If you can't find it, ask: someone will show you."

>rise hand
A waiter approached. 
"Can I help you?" — he asks.

>ask about toilet
"Where can I find the toilet?" — you ask. 
""Oh yes, it's inside the door in front of the reception desk." — the waiter answer.

>stand up
But you aren't in anything at the moment.

"You still haven't gone to the toilet?" — Monica asks.

>w
Reception
The receptionist stands behind a tastefully crafted wooden desk, ready to assist guests with a genuine smile. 
Stairs lead to the upper floors. To the east is the dining room, along the wall is a door.

>ask about toilet
(addressing the receptionist)
"Where can I find the toilet?" — you ask. 
"It's the door right in front." — the receptionist answer.

>look
Reception
The receptionist stands behind a tastefully crafted wooden desk, ready to assist guests with a genuine smile. 
Stairs lead to the upper floors. To the east is the dining room, along the wall is a door.

>enter toilet
(first opening the bathroom door)

Bathroom antechamber
The small room is floored and covered with white tiles; on some tiles on the walls there are colorful drawings of flowers.
There are three doors: one is made of light wood and leads outside, the other two are white, one facing east and the other west, for men and women respectively. Near each door there is an electrical wall switch.

A lamp is at the ceiling, but it's off; the light comes from the wooden door.

On a side there is the sink where you can wash your hands.

>switch on
You switched on the bathroom antechamber ceiling lamp.

>close door
Which do you mean, the bathroom door, the women's toilet door or the men's toilet door?

>bathroom
You close the bathroom door.

>switch on men
You switched on the men's toilet ceiling lamp.

>enter men
(first opening the men's toilet door)

Men's toilet
The floor and walls are covered with white tiles. The wc is in the middle of the wall in front of you, above it is a large white button.

>close door
You close the men's toilet door.

>lock door
Click! You turn the latch, and the door is locked.

>pee
An inevitable need has finally been resolved!

>open door
(first unlocking the men's toilet door)
Click! You turn the latch, and the door is unlocked.

You open the men's toilet door.

>exit
Would you have liked to find the toilet dirty when you entered?

>flush
You cleaned the bowl with the water flush.

>antechamber
That noun did not make sense in this context.

>exit
Bathroom antechamber
The small room is floored and covered with white tiles; on some tiles on the walls there are colorful drawings of flowers.
There are three doors: one is made of light wood and leads outside, the other two are white, one facing east and the other west, for men and women respectively. Near each door there is an electrical wall switch.

The light comes from a ceiling lamp.

On a side there is the sink where you can wash your hands.

>switch off men's
You switched off the men's toilet ceiling lamp.

>close door
Which do you mean, the men's toilet door, the bathroom door or the women's toilet door?

>men's
You close the men's toilet door.

>wash hands
Now your hands smell clean.

>open door
Which do you mean, the men's toilet door, the bathroom door or the women's toilet door?

>open bath
You open the bathroom door.

>switch off
You switched off the bathroom antechamber ceiling lamp.

>exit
Reception
The receptionist stands behind a tastefully crafted wooden desk, ready to assist guests with a genuine smile. 
Stairs lead to the upper floors. To the east is the dining room, along the wall is a door.

>close door
Which do you mean, the bathroom door or the sliding door?

>bath
You close the bathroom door.

>dining
(heading east)

Dining room
The tables are elegantly set with crisp linens. Around the tables is a bench covered in dark green velvet. 
The reception area is to the west, to the north is the buffet area, and to the east a door leads to the kitchen.

On the bench is Monica.

You can also see a waitress and a waiter here.

The receptionist walks away from his desk and comes into the dining room.
The cook also comes here.
Monica stands up and starts clapping, followed by all the other characters. 

Your game is over, you played very well and solved all the puzzles we set you. 
We all thank you for playing!

    *** The curtain closes ***

Would you like to RESTART, RESTORE a saved game, QUIT or UNDO the last command?

>z
Please give one of the answers above.

Would you like to RESTART, RESTORE a saved game, QUIT or UNDO the last command?

>z
Time passes.

>z
Time passes.

* * *

>flush
You cleaned the bowl with the water flush.

>flush men
There is nothing to flush here.

>flush button
You cleaned the bowl with the water flush.

I beg your pardon?

>flush men's
There is nothing to flush here.

* * *

>kiss mo
♥ "On dear!" — she whispers sweetly in your ear.

It's been a while since you've gone downstairs for breakfast, and now you feel the urge to go to the bathroom. 
You move a bit nervously, and Monica notices your discomfort. 

♥ "Sweetheart, are you all right?" — Monica asks.
"Go to the toilet, which is better." — she suggests — "If you can't find it, ask: someone will show you."

>z
Time passes.